_________________________________________________________________________________________
_________________________________________________________________________________________
_________________________________________________________________________________________
_________________________________________________________________________________________
_________________________________________________________________________________________
_________________________________________________________________________________________
________OOOOOO_______________________OOOOOO______________________________________________
______OOOOOOOOOO_____________________OOOOOO______________________________________________
______OOOOOOOOOO________WWWWW________OOOOOO______________________________________________
______OOOOOOOOOO________WWWWW________OOOOOO______________________________________________
______OOOOOOOOOO________WWWWW________OOOOOO______________________________________________
______OOOOOOOOOO________WWWWW____________________________________________________________
________OOOOOO___________________________________________________________________________
________________________________________OOOOOO___________________________________________
________________WWWWW__________________OOOOOOOO__________________________________________
______OOOOOO____WWWWW__________________OOOOOOOO__________________________________________
______OOOOOO____WWWWW________WWWWW_____OOOOOOOO__________________________________________
______OOOOOO____WWWWW________WWWWW______OOOOOO___________________________________________
______OOOOOO_________________WWWWW_______________________________________________________
______OOOOOO_________________WWWWW_______________________________________________________
_________________________________________________________________________________________
_________________________________________________________________________________________
____________WWWW_________________________________________________________________________
____________WWWW_________________________________________________________________________
____________WWWW________P____OO_________OOOOOO___________________________________________
_____________________________OO_________OOOOOO___________________________________________
________________________________________OOOOOO___________________________________________
________________________________________OOOOOO___________________________________________
____________WWWWW_______________________OOOOOO___________________________________________
_________WWWWWWW_________________________________________________________________________
_________WWWWW___________________________________________________________________________
_______WWWWWWW________________WWWWW______________________________________________________
______WWWWWW_____OOOOOO______WWWWWW______________________________________________________
______WWWWWW_____OOOOOO_____WWWWWW________WWWWW__________________________________________
_________________OOOOOO____WWWWWW________WWWWWWW_________________________________________
__________________________WWWWWW_________WWWWWWW_________________________________________
_________________________WWWWWW__________WWWWWWW_________________________________________
_________________________WWWWW____________WWWWW__________________________________________
_________________________________________________________________________________________
___WWWWWWWW______________________________________________________________________________
___WWWWWWWW______________________________OO______________________________________________
___WWWWWWWW______OOOOOOOOO_____________OOOOOO____________________________________________
___WWWWWWWW______OOOOOOOOO____________OOOOOO_____________________________________________
___WWWWWWWW______OOOOOOOOO___________OOOOOO______________________________________________
_________________OOOOOOOOO__________OOOOOO_______________________________________________
___________________________________OOOOOO________________________________________________
_____________________________________OO__________________________________________________
_________________________________________________________________________________________
_________________________________________________________________________________________
_________________________________________________________________________________________
_________________________________________________________________________________________
_________________________________________________________________________________________
_________________________________________________________________________________________
_________________________________________________________________________________________
_________________________________________________________________________________________
_________________________________________________________________________________________
______WWWWWWWWWWWWWWWWWWWWWWWWWWWWWWWWWWWWWWWWWWWWWWWWWW_________________________________
______WWWWWWWWWWWWWWWWWWWWWWWWWWWWWWWWWWWWWWWWWWWWWWWWWW_________________________________
______WWWWWWWWWWWWWWWWWWWWWWWWWWWWWWWWWWWWWWWWWWWWWWWWWW_________________________________
_________________________________________________________________________________________
___________OOOOOOOOOOOOOOOOOOOOOOO_______________________________________________________
___________OOOOOOOOOOOOOOOOOOOOOOO_______________________________________________________
___________OOOOOOOOOOOOOOOOOOOOOOO_______________________________________________________
___________OOOOOOOOOOOOOOOOOOOOOOO_______________________________________________________
___________OOOOOOOOOOOOOOOOOOOOOOO_______________________________________________________
___________OOOOOOOOOOOOOOOOOOOOOOO_______________________________________________________
___________OOOOOOOOOOOOOOOOOOOOOOO_______________________________________________________
___________OOOOOOOOOOOOOOOOOOOOOOO_______________________________________________________
_________________________________________________________________________________________
_________________________________________________________________________________________
_________________________________________________________________________________________
_________________________________________________________________________________________
_________________________________________________________________________________________
_________________________________________________________________________________________
_________________________________________________________________________________________
_________________________________________________________________________________________
_________________________________________________________________________________________
_________________________________________________________________________________________
_________________________________________________________________________________________
_________________________________________________________________________________________
_________________________________________________________________________________________
_________________________________________________________________________________________
_________________________________________________________________________________________
_________________________________________________________________________________________
_________________________________________________________________________________________
_________________________________________________________________________________________
_________________________________________________________________________________________
_________________________________________________________________________________________
_________________________________________________________________________________________
